########################################################################################
#...............K.............d.......D..........................................D.....#
#............###.................###............................................##.....#
#.................#####...............######...................................#.......#
#....@...................E....###...##........................................#........#
#......................#####.......#.........................................#.........#
#..............X...............######.......................................#..........#
#.............................#............E......E........................#...........#
############################################################...#####...#################