########################################
#...............K.............d.......D#
#......................................#
#.................#####................#
#....@.................................#
#......................#####...........#
#..............X...............######..#
#......................................#
########################################
