########################################
#...............K.............d.......D#
#............###.................###...#
#.................#####...............##
#....@...................E....###...##.#
#......................#####.......#...#
#..............X...............######..#
#.............................#........#
########################################
